#################
#       #       #
# # ### # ### # #
#               #
# # # ##### # # #
#   #   #   #   #
### ### # ### ###
  # #       # #  
### # ## ## # ###
      #   #      
### # ##### # ###
  # #       # #  
### # ##### # ###
#       #       #
# ## ## # ## ## #
#  #         #  #
## # # ### # # ##
#    #  #  #    #
# ##### #  #### #
#               #
#################