########
#      # 
# #### #
#      # 
# #### #
#   p  #
########