########
#      #
# #### #
#      #
# #### #
#      #
########